#######
#  P  #
#  XX #
#   OO#
#######